1111PCE011111111
1111111111111111
